W W E W W W W W W W W W W W W W E W W
W W E W W S S S S S S S S S S W E W W
E S W S W S W W W S W W W S W S W S E
W S S S S S S S S S S S S S S S S S W
W B W W W W S W W S W W W W W S W B W
W S S S S S S S S S S S S S S S S S W
W W W S W W S W W S W W S W W S W W W
W W W S W W S W W S W W S W W S W W W
W W W S W W S S S B W W S W W S W W W
W W S S S W S W W S W W S W S S S W W
W S S W S W S W W W W W S W S W E E W
W S S S S S S W 1 3 2 W S S S S S S W
W S W S W W S W E 4 E W S W W S W S W
W S S S W W S W E W E S S W W S S S W
W S W W W W W W S W S W W W W W W S W
W S S S S S S S S W S S S S S S S S W
W S W W W W W W S W S W W W W W W S W
W S S S S S S S S P S S S S S S S S W
E B W W W W W W W S W W W W W W W B E
W S S S S S S S S S S S S S S S S S W
W W W W W W W W W W W W W W W W W W W