W W W W W W W W W W W W W W W W W W W
W S S S S B S S S S S S S B S S S S W
E S W S W S W W W S W W W S W S W S E
W S W S S S S W S S S W W S W S S S W
W S W W W W S W W S W W W W W S W W W
W S S S S S S S S B S S S S S S S S W
W W W S W W S W W S W W S W W S W W W
W W W S W W S W W S W W S W W S W W W
W W W S W W S S S S S S S W W S W W W
W W S S S W S W E S E W S W S S S W W
W S S W S W S W E W E W S W S W S S W
W S S S S S S W 1 3 2 W S S S S S S W
E S W S W W S E E 4 E E S W W S W S E
W S S S W W S E W W W E S W W S S S W
W S W W W W W E S P S E W W W W W S W
W S S S S S S S S W S S S S S S S S W
W S W W W S W W S W S W W S W W W S W
W S S S W S S S S S S S S S W S S S W
E B W W W W W W W S W W W W W W W B E
W S S S W S S S S S S S S S W S S S W
W W W W W W W W W W W W W W W W W W W