W W W W W W W W W W W W W W W W W W W
W S S S W W S S S S S S S W W S S S W
W B W S W W S W W W S W W W W S W B W
W S S S S S S W W S S W W W W S S S W
W W W W W W S W W S W W W W W S W W W
E S S S S S S S S S S S S S S S S S E
W W W S W W S W W S W W S W W S W W W
E W W S W W S W W S W W S W W S W W E
W W W S W W S W W S W W S W W S W W W
W W S S S W S E E E W W S W S S S W W
E E E W S W S E W W W W S W S W E E E
W S S S S S S E 1 3 2 W S S S S S S W
W S W W W W S E W 4 E W S W W W W S W
W S S S S W S S S W S S S W S S S S W
W S W W W W W W S W S W W W W W W S W
E E E S S S S S S S S S S S S S E E E
W S W W W W W W S W S W W W W W W S W
W S S S S S S S S S S S S S S S S S W
W B W W W W W W W S W W W W W W W B W
W S S S S S S S S P S S S S S S S S W
W W W W W W W W W W W W W W W W W W W