W W W W W W W W W W W W W W W W W W W
W S S S S S S S S S S S S S S S S S W
W B W W W W W W S W S W W W W W W B W
W S S S S S S S S S S S S S S S S S W
W W W W W W W W W S W W W W W W W W W
E E E S S S S S S S S S S S S S S E E
W W W S W W W W W S W W W W W S W W W
E W W S S S S W W S W W S S S S W W E
W W W S W W S W W S W W S W W S W W W
W S S S S W S W W S W W S W S S S S W
W W W W S W S W W S W W S W S W W W W
W S S S S W S W 1 3 2 W S W S S S S W
W S W W W W S W E 4 E W S W W W W S W
W S S S S W S S S W S S S W S S S S W
W S W W W W W W S W S W W W W W W S W
E E E S S S S S S S S S S S S S E E E
W S W W W W W W S W S W W W W W W S W
W S S S S S S S S S S S S S S S S S W
W B W W W W W W W S W W W W W W W B W
W S S S S S S S S P S S S S S S S S W
W W W W W W W W W W W W W W W W W W W